{
  "maxLevelProgress": 3,

  "1": {
    "maxArrows": 5,
    "level": [
      [ 1, 1, 1, 1, 1, 1, 1, 1, 1, 1 ],
      [ 1, 0, 0, 0, 0, 0, 0, 0, 0, 1 ],
      [ 1, 0, 2, 0, 0, 0, 0, 0, 0, 1 ],
      [ 1, 0, 0, 0, 0, 0, 0, 0, 0, 1 ],
      [ 1, 0, 0, 0, 0, 0, 0, 0, 0, 1 ],
      [ 1, 1, 1, 1, 1, 1, 1, 0, 0, 1 ],
      [ 1, 0, 0, 0, 0, 3, 1, 0, 0, 1 ],
      [ 1, 0, 0, 1, 1, 1, 1, 0, 0, 1 ],
      [ 1, 0, 0, 0, 0, 0, 0, 0, 0, 1 ],
      [ 1, 1, 1, 1, 1, 1, 1, 1, 1, 1 ]
    ]
  },
  "2": {
    "maxArrows": 10,
    "level": [
      [ 1, 1, 1, 1, 1, 1, 1, 1, 1, 1 ],
      [ 1, 0, 0, 0, 0, 0, 0, 0, 0, 1 ],
      [ 1, 0, 0, 0, 0, 0, 0, 0, 0, 1 ],
      [ 1, 0, 0, 0, 0, 0, 1, 0, 0, 1 ],
      [ 1, 0, 0, 0, 0, 0, 1, 0, 0, 1 ],
      [ 1, 0, 3, 0, 1, 2, 1, 0, 0, 1 ],
      [ 1, 0, 0, 0, 1, 1, 1, 0, 0, 1 ],
      [ 1, 0, 1, 0, 0, 0, 0, 0, 0, 1 ],
      [ 1, 0, 0, 0, 1, 0, 0, 0, 0, 1 ],
      [ 1, 1, 1, 1, 1, 1, 1, 1, 1, 1 ]
    ]
  },
  "3": {
    "maxArrows": 100,
    "level": [
      [ 1, 1, 1, 1, 1, 1, 1, 1, 1, 1 ],
      [ 1, 0, 0, 0, 0, 0, 0, 0, 0, 1 ],
      [ 1, 0, 1, 1, 1, 1, 0, 0, 0, 1 ],
      [ 1, 0, 1, 0, 0, 0, 0, 0, 0, 1 ],
      [ 1, 0, 1, 1, 1, 0, 0, 0, 0, 1 ],
      [ 1, 0, 1, 0, 0, 0, 0, 0, 0, 1 ],
      [ 1, 0, 1, 0, 0, 0, 0, 0, 0, 1 ],
      [ 1, 0, 1, 0, 0, 0, 0, 3, 2, 1 ],
      [ 1, 0, 0, 0, 0, 0, 0, 0, 0, 1 ],
      [ 1, 1, 1, 1, 1, 1, 1, 1, 1, 1 ]
    ]
  }
}