{
  "maxLevelProgress": 2,

  "1": {
    "maxArrows": 10,
    "banners": [ "assets/banners/tip1.png" ],
    "level": [
      [ 1, 1, 1, 1, 1, 1, 1, 1, 1, 1 ],
      [ 1, 0, 0, 0, 0, 0, 0, 0, 0, 1 ],
      [ 1, 0, 0, 0, 0, 0, 0, 0, 0, 1 ],
      [ 1, 0, 0, 3, 0, 0, 2, 0, 0, 1 ],
      [ 1, 0, 0, 0, 0, 0, 0, 0, 0, 1 ],
      [ 1, 0, 0, 1, 1, 1, 0, 0, 0, 1 ],
      [ 1, 0, 0, 0, 0, 1, 0, 0, 0, 1 ],
      [ 1, 0, 0, 1, 1, 1, 0, 0, 0, 1 ],
      [ 1, 0, 0, 1, 0, 0, 0, 0, 0, 1 ],
      [ 1, 1, 1, 1, 1, 1, 1, 1, 1, 1 ]
    ]
  },
  "2": {
    "maxArrows": 10,
    "banners": [ "assets/banners/tip2.png" ],
    "level": [
      [ 1, 1, 1, 1, 1, 1, 1, 1, 1, 1 ],
      [ 1, 3, 0, 0, 4, 0, 0, 0, 0, 1 ],
      [ 1, 0, 0, 0, 0, 0, 0, 0, 0, 1 ],
      [ 1, 0, 0, 0, 0, 0, 0, 0, 0, 1 ],
      [ 1, 0, 0, 0, 0, 4, 0, 0, 0, 1 ],
      [ 1, 0, 0, 0, 0, 0, 0, 0, 0, 1 ],
      [ 1, 0, 0, 0, 0, 0, 4, 0, 0, 1 ],
      [ 1, 0, 0, 0, 0, 0, 0, 0, 0, 1 ],
      [ 1, 0, 0, 0, 0, 0, 0, 0, 2, 1 ],
      [ 1, 1, 1, 1, 1, 1, 1, 1, 1, 1 ]
    ]
  }
}